S100010000
0101010100
0101010100
0101010100
0101010100
0101010100
0101010100
0101010100
0101010100
000100010G