S000000000
0111111110
0100000000
0101111111
0100000000
0111111110
0100000000
0101111111
0110000000
000000000G