S000000000
0111111110
0100000000
0101111111
0100000000
0111111110
0001000010
0100011010
0111110010
000000000G