S111000100
0111010100
0001010000
0101011110
0101010100
0111010101
0100010101
0101110100
0000000100
000011110G